5,5,5,5,5,1,1,1,1,1,1
5,5,5,5,5,1,2,2,2,2,1
5,5,5,5,5,1,2,ufmn2,of0,2,1
1,1,1,1,1,1,2,2,2,2,1
1,2,2,2,2,1,2,2,2,2,1
1,2,2,2,2,1,2,2,2,2,1
1,2,2,2,2,1,2,2,2,2,1
1,2,2,2,2,1,1,1,1,1,1
1,2,oe0,uemn2,2,1,5,5,5,5,5
1,2,2,2,2,1,5,5,5,5,5
1,1,1,1,1,1,5,5,5,5,5