6,6,6,6,3,3,3,6,6,6,6
6,3,3,3,3,3,3,3,3,3,6
6,3,3,3,3,3,3,3,3,3,6
6,3,ueMg3,3,6,4,6,3,ufMg3,3,6
3,3,3,6,4,4,4,6,3,3,3
oe3,3,6,4,4,4,4,4,6,3,of3
3,3,3,6,4,4,4,6,3,3,3
6,3,ueMg3,3,6,4,6,3,ufMg3,3,6
6,3,3,3,3,3,3,3,3,3,6
6,3,3,3,3,3,3,3,3,3,6
6,6,6,6,3,3,3,6,6,6,6