5,5,5,5,5,5,5,5,5,5,5
5,6,6,3,3,3,3,3,6,6,5
6,3,3,3,3,3,3,3,3,3,6
6,3,uemg3,3,3,6,3,3,ufmg3,3,6
3,3,3,3,6,6,6,3,3,3,3
3,oe3,3,3,6,6,6,3,3,of3,3
3,3,3,3,6,6,6,3,3,3,3
6,3,uemg3,3,3,6,3,3,ufmg3,3,6
6,3,3,3,3,3,3,3,3,3,6
5,6,6,3,3,3,3,3,6,6,5
5,5,5,5,5,5,5,5,5,5,5