2,2,2,2,2,2,2,2,2,2,2
2,2,2,1,2,uemn2,2,2,2,of3,2
2,2,1,1,2,2,1,2,2,2,2
2,2,1,2,2,1,4,2,2,ueMn2,2
2,2,2,2,1,4,4,4,2,2,2
2,1,2,2,2,4,4,4,1,2,2
2,1,2,ufmn2,2,1,4,4,1,2,2
2,2,2,2,2,2,1,1,2,2,2
2,2,oe3,2,2,2,ufrn2,2,1,2,2
2,2,2,2,2,2,2,1,1,2,2
2,2,2,2,2,2,2,2,2,2,2