5,4,4,4,4,4,4,5,5,5,5
5,4,1,1,1,1,4,4,4,4,5
4,4,oe8,4,4,uera4,4,4,1,4,5
1,4,4,4,1,1,4,1,1,4,5
1,1,uera4,4,1,1,4,1,4,4,5
1,4,4,4,4,4,4,4,4,5,5
4,4,4,4,1,1,4,5,ufra4,4,4
5,5,4,1,1,4,4,5,4,1,4
5,4,4,4,4,4,5,4,of8,1,4
5,4,1,1,1,ufra4,5,4,1,1,4
5,4,1,4,4,4,5,4,4,4,4