5,5,5,5,5,5,5,5,1,1,1
5,5,1,1,1,5,5,5,5,5,1
5,1,0,0,0,5,5,5,uerm0,5,5
5,5,0,oe0,0,7,7,0,0,1,5
5,5,5,0,uera0,5,5,5,0,0,1
5,5,5,5,7,5,5,5,7,0,1
5,5,5,5,7,5,0,0,7,5,5
5,5,5,0,0,0,0,ufMa0,of0,5,5
1,5,5,5,2,2,ufmg0,0,5,5,5
1,1,5,5,5,5,2,2,5,5,5
1,1,1,1,5,5,5,5,5,5,5