5,5,5,5,5,5,5,5,5,5,5
5,5,1,1,1,5,5,5,5,5,5
5,oe0,0,0,1,1,5,5,5,5,5
5,5,0,ueMa0,0,1,5,5,5,5,5
5,5,5,0,0,0,5,5,5,5,5
5,5,5,5,7,5,5,0,0,5,5
5,5,5,5,0,0,0,ufMa0,0,1,5
5,5,5,5,5,5,0,0,of0,1,5
5,5,5,5,5,5,5,0,1,1,5
5,5,5,5,5,5,5,1,1,5,5
5,5,5,5,5,5,5,5,5,5,5