4,4,1,1,5,5,5,1,1,4,4
4,4,4,1,5,5,5,1,4,4,4
4,4,uema4,4,5,5,5,4,ufma4,4,4
1,4,4,4,5,5,5,4,4,4,1
1,8,4,4,4,5,4,4,4,8,1
oe8,8,4,4,4,4,4,4,4,8,of8
1,8,4,4,4,5,4,4,4,8,1
1,4,4,4,5,5,5,4,4,4,1
4,4,uema4,4,5,5,5,4,ufma4,4,4
4,4,4,1,5,5,5,1,4,4,4
4,4,1,1,5,5,5,1,1,4,4