5,5,5,5,5,5,5,5,5,5,5
5,5,5,5,5,5,5,5,5,5,5
5,3,3,3,3,3,3,3,5,5,5
5,3,ufra3,3,3,ufmg3,3,oe3,3,5,5
5,3,3,3,3,3,3,3,3,5,5
5,5,6,6,6,6,6,6,6,5,5
5,5,3,3,3,3,3,3,3,3,5
5,5,3,of3,3,uemg3,3,3,3,uera3,5
5,5,5,3,3,3,3,3,3,3,5
5,5,5,5,5,5,5,5,5,5,5
5,5,5,5,5,5,5,5,5,5,5