5,5,5,5,5,5,5,5,5,5,5
5,5,3,6,6,6,6,6,3,5,5
5,5,oe3,3,6,6,6,3,of3,5,5
5,5,3,3,6,6,6,3,3,5,5
5,5,3,3,3,6,3,3,3,5,5
5,5,3,3,3,3,3,3,3,5,5
5,5,3,3,3,3,3,3,3,5,5
5,5,3,3,3,3,3,3,3,5,5
5,5,3,uema3,3,3,3,ufma3,3,5,5
5,5,3,3,3,3,3,3,3,5,5
5,5,5,5,5,5,5,5,5,5,5