5,5,5,5,5,5,5,5,5,5,5
5,5,5,5,5,5,5,5,5,5,5
5,5,5,5,5,5,5,5,5,5,5
1,1,0,0,5,5,5,5,5,5,5
1,oe0,uera0,0,5,5,5,5,5,5,5
0,0,0,0,5,5,0,0,0,0,5
5,5,5,5,5,5,0,ufra0,of0,1,5
5,5,5,5,5,5,0,0,1,1,5
5,5,5,5,5,5,5,5,5,5,5
5,5,5,5,5,5,5,5,5,5,5
5,5,5,5,5,5,5,5,5,5,5