5,5,5,5,5,5,5,5,5,5,5
5,5,5,5,5,5,5,5,5,5,5
1,1,1,1,1,1,1,1,1,1,1
1,0,0,0,0,0,1,0,0,0,1
1,0,ufra0,0,0,0,1,0,ufra0,0,1
1,oe0,0,0,1,0,1,0,0,of0,1
1,0,ufMg0,0,1,0,0,0,ufMg0,0,1
1,0,0,0,1,0,0,0,0,0,1
1,1,1,1,1,1,1,1,1,1,1
5,5,5,5,5,5,5,5,5,5,5
5,5,5,5,5,5,5,5,5,5,5