5,5,5,5,5,5,5,5,5,5,5
5,3,3,3,5,5,5,3,3,3,5
5,3,oe3,3,5,5,5,3,3,3,5
5,3,3,ueMg3,3,3,3,3,3,3,5
5,5,5,3,3,6,3,3,5,5,5
5,5,5,3,6,6,6,3,5,5,5
5,5,5,3,3,6,3,3,5,5,5
5,3,3,3,3,3,3,ufMg3,3,3,5
5,3,3,3,5,5,5,3,of3,3,5
5,3,3,3,5,5,5,3,3,3,5
5,5,5,5,5,5,5,5,5,5,5