5,5,5,5,5,5,5,5,5,5,5
5,5,5,5,5,5,5,5,5,5,5
5,5,6,3,3,3,3,3,3,5,5
5,5,6,oe3,3,3,3,ufrg3,3,5,5
5,5,6,3,3,3,3,3,3,5,5
5,5,6,6,6,6,6,6,6,5,5
5,5,3,3,3,3,3,3,6,5,5
5,5,3,uerg3,3,3,3,of3,6,5,5
5,5,3,3,3,3,3,3,6,5,5
5,5,5,5,5,5,5,5,5,5,5
5,5,5,5,5,5,5,5,5,5,5