5,5,5,5,8,4,8,5,5,5,5
5,ueMg8,8,7,8,4,8,7,8,ufrg8,5
5,8,5,5,5,8,5,5,5,8,5
5,7,5,5,5,7,5,5,5,7,5
8,8,5,5,5,8,5,5,5,8,8
oe8,uera8,8,7,8,4,8,7,8,8,of8
8,8,5,5,5,8,5,5,5,8,8
5,7,5,5,5,7,5,5,5,7,5
5,8,5,5,5,8,5,5,5,8,5
5,uera8,8,7,8,4,8,7,8,ufra8,5
5,5,5,5,8,4,8,5,5,5,5