1,1,1,1,1,1,1,1,1,1,1
1,4,uera4,4,4,4,4,4,ufra4,4,1
4,4,4,4,4,4,4,4,4,4,4
8,4,4,4,4,4,4,4,4,4,8
8,8,8,4,4,4,4,4,8,8,8
8,oe8,ueMg8,8,8,8,8,8,ufMg8,of8,8
8,8,8,4,4,4,4,4,8,8,8
8,4,4,4,4,4,4,4,4,4,8
4,4,4,4,4,4,4,4,4,4,4
1,4,uera4,4,4,4,4,4,ufra4,4,1
1,1,1,1,1,1,1,1,1,1,1
