5,5,5,5,5,5,5,5,5,5,5
5,5,1,1,1,5,5,5,5,5,5
5,oe0,0,0,1,1,5,5,5,5,5
5,5,0,uera0,0,1,5,5,5,5,5
5,5,5,0,0,0,5,5,5,5,5
5,5,5,5,7,5,5,0,0,5,5
5,5,5,5,0,0,0,ufra0,0,1,5
5,5,5,5,5,5,0,0,of0,1,5
5,5,5,5,5,5,5,0,1,1,5
5,5,5,5,5,5,5,1,1,5,5
5,5,5,5,5,5,5,5,5,5,5