4,4,4,4,4,4,4,4,4,4,4
1,4,uema4,4,4,4,4,4,ufmn4,4,1
8,1,1,4,4,4,4,4,1,1,8
8,8,8,1,1,1,1,1,8,8,8
8,8,8,8,8,8,8,8,8,of8,8
8,8,8,8,8,8,8,ufMg8,8,8,4
8,8,8,8,8,8,8,8,8,4,4
8,8,8,ueMa8,8,8,8,8,8,4,4
8,8,8,8,8,8,8,8,4,4,4
8,oe8,8,8,8,8,8,4,4,4,4
8,8,8,8,8,8,8,4,4,4,4