2,2,2,2,2,1,4,4,4,4,4
2,oe8,2,ueMn2,2,1,4,4,4,4,4
2,2,2,2,2,4,4,4,4,4,4
2,ueMn2,2,2,2,2,4,4,4,4,4
1,1,1,4,2,2,4,4,4,4,4
4,4,4,4,4,2,2,2,4,4,1
4,4,4,4,4,2,2,2,1,1,2
4,4,4,4,4,4,4,2,2,ufMn2,2
4,4,4,4,4,4,1,1,2,2,2
4,4,4,4,1,1,2,ufMn2,2,of8,2
4,4,4,1,2,2,2,2,2,2,2